###############################
#     ws *  1 * 2 *  * * *    #
# # # #*# # #*#*# # # #*#*#*# #
#   i     ***  *  1   * 2 * * #
#x# # # # #*# # #*#*# # # # #*#
#f           **  *  *   1     #
# # # # # # # # # #*# #*# # # #
#*  *      *  *      *        #
# # # # #*# # # #*#*# # # # # #
#*    **  *       *           #
# #*# # # # # # #*# # # # # # #
#           *   *  *          #
###############################