###############################
#     ws *    * 2 *  * * *    #
# # # #*# # #*#*# # # #*#*#*# #
#   i     ***  *      * 2 * * #
#x# # # # #*# # #*#*# # # # #*#
#f           **  *  *         #
# # # # # # # # # #*# #*# # # #
#*  *      b  *      *        #
# # # # #*# # # #*#*# # # # # #
#*    **  *       *           #
# #*# # # # # # #*# # # # # # #
#    1      *   *  *          #
###############################