###############################
#   i ws *    *   *  * * *    #
# # # #*# # #*#*# # # #*#*#*# #
#   d     ***  *      *   * * #
#x# # # # #*# # #*#*# # # # #*#
#f           **  *  *         #
# # # # # # # # # #*# #*# # # #
#*  *  1   b  *      *        #
# # # # #*# # # #*#*# # # # # #
#*    **  *       *           #
# #*# # # # # # #*# # # # # # #
#    u      *   *  *     2    #
###############################