###############################
#          **            1    #
# # # # # # # # # # # # # # # #
#    *   *     2         2    #
#x# # # # #*#s# # #f# # # # # #
#      3 *  *                #
# # # #d# #s#*# #b# # # # # # #
#             *     3         #
# # # # #*# # #*# # # # # # # #
#*** * *** *3**** *** * * ** *#
# # # # # # #*# # # # # # # # #
#              2              #
###############################