###############################
#P    ws *    *   *  * * *    #
# # # #*# # #*#*# # # #*#*#*# #
#   i     ***  *      *   * * #
#x# # # # #*# # #*#*# # # # #*#
#f           **  *  *         #
# # # # # # # # # #*# #*# # # #
#*  *  2   b  *      *        #
# # # # #*# # # #*#*# # # # # #
#*    **  *       *           #
# #*# # # # # # #*# # # # # # #
#           *   *  *          #
###############################