###############################
#      *d *  3 * 3 *  * * *   #
# # # #*# # #*#*# # # #*#*#*# #
#   *     ***  *  3   * 2 * * #
# # # # # #*# # #*#*# # # # #*#
#f      i   ** x *  *         #
# # # # # # # # # #*# #*# # # #
#*  *      *  *      *   f    #
# # # # #*# # # #*#*# # # # # #
#*    **  *    3  *      w    #
# #*# # # # # # #*# # # # # # #
#           *   *  *          #
###############################